{
  "fonts": {
    "TibetanMangala": {
      "33": "ཀ",
      "34": "ཁ", 
      "35": "ག",
      "36": "ང",
      "37": "ཅ",
      "38": "ཆ",
      "39": "ཇ",
      "40": "ཉ",
      "41": "ཏ",
      "42": "ཐ",
      "43": "ད",
      "44": "ན",
      "45": "པ",
      "46": "ཕ",
      "47": "བ",
      "48": "མ",
      "49": "ཙ",
      "50": "ཚ",
      "51": "ཛ",
      "52": "ཝ",
      "53": "ཞ",
      "54": "ཟ",
      "55": "འ",
      "56": "ཡ",
      "57": "ར",
      "58": "ལ",
      "59": "ཤ",
      "60": "ས",
      "61": "ཧ",
      "62": "ཨ",
      "205": "པ",
      "220": "ི",
      "221": "ི"
    }
  }
}